
{
"name":"mall",

"world":[
[7, 7, 7, 7, 7, 7, 7, 7, 7, 7, 7, 7, 7, 7, 7, 7, 7, 7, 7, 7, 7, 7, 7, 7, 7],
[7, 0, 0, 0, 0, 0, 0, 0, 0, 7, 0, 0, 0, 0, 0, 7, 0, 0, 0, 0, 7, 0, 0, 0, 7],
[7, 0, 0, 0, 0, 0, 0, 0, 0, 7, 0, 0, 0, 0, 0, 7, 0, 0, 0, 0, 7, 0, 0, 0, 7],
[7, 0, 0, 0, 0, 0, 0, 0, 0, 7, 0, 0, 0, 0, 0, 7, 0, 0, 0, 0, 7, 0, 0, 0, 7],
[7, 0, 0, 0, 0, 0, 0, 0, 0, 7, 0, 0, 0, 0, 0, 7, 0, 0, 0, 0, 7, 0, 0, 0, 7],
[7, 7, 7, 7, 7, 7, 7, 0, 0, 7, 7, 7, 0, 7, 7, 7, 7, 0, 0, 7, 7, 0, 0, 0, 7],
[7, 0, 0, 0, 0, 0, 7, 0, 0, 0, 0, 0, 0, 0, 0, 0, 0, 0, 0, 0, 0, 0, 0, 0, 7],
[7, 0, 0, 0, 0, 0, 7, 0, 0, 0, 0, 0, 0, 0, 0, 0, 0, 0, 0, 0, 0, 0, 0, 0, 7],
[7, 0, 0, 0, 0, 0, 7, 0, 0, 0, 0, 0, 0, 0, 0, 0, 0, 0, 0, 0, 7, 7, 7, 7, 7],
[7, 0, 0, 0, 0, 0, 7, 0, 0, 0, 0, 0, 0,  0, 0, 0, 0, 0, 0, 0, 7, 0, 0, 0, 7],
[7, 0, 0, 0, 0, 0, 0, 0, 0, 0, 0, 0,  0, 2,  0, 0, 0, 0, 0, 0, 0, 0, 0, 0, 7],
[7, 0, 0, 0, 0, 0, 0, 0, 0, 0, 0,  0, 2, 4, 2,  0, 0, 0, 0, 0, 0, 0, 0, 0, 7],
[7, 0, 0, 0, 0, 0, 7, 0, 0, 0, 0, 0,  0, 2,  0, 0, 0, 0, 0, 0, 7, 0, 0, 0, 7],
[7, 0, 0, 0, 0, 0, 7, 0, 0, 0, 0, 0, 0,  0, 0, 0, 0, 0, 0, 0, 7, 7, 7, 7, 7],
[7, 0, 0, 0, 0, 0, 7, 0, 0, 0, 0, 0, 0, 0, 0, 0, 0, 0, 0, 0, 7, 0, 0, 0, 7],
[7, 7, 7, 7, 7, 7, 7, 0, 0, 0, 0, 0, 0, 0, 0, 0, 0, 0, 0, 0, 7, 0, 0, 0, 7],
[7, 0, 0, 0, 0, 0, 7, 0, 0, 0, 0, 0, 0, 0, 0, 0, 0, 0, 0, 0, 0, 0, 0, 0, 7],
[7, 0, 0, 0, 0, 0, 7, 0, 0, 0, 0, 0, 0, 0, 0, 0, 0, 0, 0, 0, 7, 0, 0, 0, 7],
[7, 0, 0, 0, 0, 0, 7, 0, 0, 0, 0, 0, 0, 0, 0, 0, 0, 0, 0, 0, 7, 0, 0, 0, 7],
[7, 0, 0, 0, 0, 0, 0, 0, 0, 0, 0, 0, 0, 0, 0, 7, 7, 7, 0, 0, 7, 7, 7, 7, 7],
[7, 0, 0, 0, 0, 0, 0, 0, 7, 7, 0, 7, 0, 0, 0, 7, 9, 9, 9, 9, 9, 9, 9, 9, 7],
[7, 0, 0, 0, 0, 0, 7, 0, 7, 0, 0, 7, 0, 7, 0, 7, 9, 9, 9, 9, 9, 9, 9, 9, 7],
[7, 0, 0, 0, 0, 0, 7, 0, 7, 0, 0, 7, 0, 0, 0, 7, 9, 9, 9, 9, 9, 9, 9, 9, 7],
[7, 0, 0, 0, 0, 0, 0, 0, 0, 0, 0, 7, 0, 0, 0, 7, 9, 9, 9, 9, 9, 9, 9, 9, 7],
[7, 7, 7, 7, 7, 7, 7, 7, 7, 7, 7, 7, 0, 0, 0, 7, 7, 7, 7, 7, 7, 7, 7, 7, 7]],

"tiles":[
[7, 7, 7, 7, 7, 7, 7, 7, 7, 7, 7, 7, 7, 7, 7, 7, 7, 7, 7, 7, 7, 7, 7, 7, 7],
[7,11,11,11,11,11,11,11,11, 7, 9, 9, 9, 9, 9, 7,11,11,11,11, 7,11,11,11, 7],
[7,11,11,11,11,11,11,11,11, 7, 9, 9, 9, 9, 9, 7,11,11,11,11, 7,11,11,11, 7],
[7,11,11,11,11,11,11,11,11, 7, 9, 9, 9, 9, 9, 7,11,11,11,11, 7,11,11,11, 7],
[7,11,11,11,11,11,11,11,11, 7, 9, 9, 9, 9, 9, 7,11,11,11,11, 7,11,11,11, 7],
[7, 7, 7, 7, 7, 7, 7,11,11, 7, 7, 7, 9, 7, 7, 7, 7,11,11, 7, 7,11,11,11, 7],
[7,11,11,11,11,11, 7,11,11,11,11,11,11,11,11,11,11,11,11,11,11,11,11,11, 7],
[7,11,11,11,11,11, 7,11,11,11,11,11,11,11,11,11,11,11,11,11,11,11,11,11, 7],
[7,11,11,11,11,11, 7,11,11,11,11,11,11,11,11,11,11,11,11,11, 7, 7, 7, 7, 7],
[7,11,11,11,11,11, 7,11,11,11,11,11,11, 3,11,11,11,11,11,11, 7, 9, 9, 9, 7],
[7,11,11,11,11,11,11,11,11,11,11,11, 3, 2, 3,11,11,11,11,11, 9, 9, 9, 9, 7],
[7,11,11,11,11,11,11,11,11,11,11, 3, 2, 4, 2, 3,11,11,11,11, 9, 9, 9, 9, 7],
[7,11,11,11,11,11, 7,11,11,11,11,11, 3, 2, 3,11,11,11,11,11, 7, 9, 9, 9, 7],
[7,11,11,11,11,11, 7,11,11,11,11,11,11, 3,11,11,11,11,11,11, 7, 7, 7, 7, 7],
[7,11,11,11,11,11, 7,11,11,11,11,11,11,11,11,11,11,11,11,11, 7,11,11,11, 7],
[7, 7, 7, 7, 7, 7, 7,11,11,11,11,11,11,11,11,11,11,11,11,11, 7,11,11,11, 7],
[7,11,11,11,11,11, 7,11,11,11,11,11,11,11,11,11,11,11,11,11,11,11,11,11, 7],
[7,11,11,11,11,11, 7,11,11,11,11,11,11,11,11,11,11,11,11,11, 7,11,11,11, 7],
[7,11,11,11,11,11, 7,11,11,11,11,11,11,11,11,11,11,11,11,11, 7,11,11,11, 7],
[7,11,11,11,11,11,11,11,11,11,11,11,11,11,11, 7, 7, 7,11,11, 7, 7, 7, 7, 7],
[7,11,11,11,11,11,11,11, 7, 7,11, 7,11,11,11, 7, 9, 9, 9, 9, 9, 9, 9, 9, 7],
[7,11,11,11,11,11, 7,11, 7, 9, 9, 7,11, 7,11, 7, 9, 9, 9, 9, 9, 9, 9, 9, 7],
[7,11,11,11,11,11, 7,11, 7, 9, 9, 7,11,10,11, 7, 9, 9, 9, 9, 9, 9, 9, 9, 7],
[7,11,11,11,11,11, 7,11, 7, 9, 9, 7,11,11,11, 7, 9, 9, 9, 9, 9, 9, 9, 9, 7],
[7, 7, 7, 7, 7, 7, 7, 7, 7, 7, 7, 7,11,11,11, 7, 7, 7, 7, 7, 7, 7, 7, 7, 7]],

"entities":[
[ 0, 0, 0, 0, 0, 0, 0, 0, 0, 0, 0, 0, 0, 0, 0, 0, 0, 0, 0, 0, 0, 0, 0, 0, 0],
[ 0, 1, 0, 0, 0, 0, 0, 0, 0, 0, 0, 0, 0, 0, 0, 0, 0, 0, 0, 0, 0, 0, 0, 4, 0],
[ 0, 0, 0, 0, 0, 0, 0, 0, 0, 0, 0, 0, 0, 0, 0, 0, 0, 0, 0, 0, 0, 0, 0, 0, 0],
[ 0, 0, 0, 0, 0, 0, 0, 0, 0, 0, 0, 0, 0, 0, 0, 0, 0, 0, 0, 0, 0, 0, 0, 0, 0],
[ 0, 0, 0, 0, 0, 0, 0, 0, 0, 0, 0, 0, 0, 0, 0, 0, 0, 0, 0, 0, 0, 0, 0, 0, 0],
[ 0, 0, 0, 0, 0, 0, 0, 0, 0, 0, 0, 0, 0, 0, 0, 0, 0, 0, 0, 0, 0, 0, 0, 0, 0],
[ 0, 0, 0, 0, 0, 0, 0, 0, 0, 0, 0, 0, 0, 0, 0, 0, 0, 0, 0, 0, 0, 0, 0, 0, 0],
[ 0, 0, 0, 0, 0, 0, 0, 0, 0, 0, 0, 0, 0, 0, 0, 0, 0, 0, 0, 0, 0, 0, 0, 0, 0],
[ 0, 0, 0, 0, 0, 0, 0, 0, 0, 0, 0, 0, 0, 0, 0, 0, 0, 0, 0, 0, 0, 0, 0, 0, 0],
[ 0, 0, 0, 0, 0, 0, 0, 0, 0, 0, 0, 0, 0, 0, 0, 0, 0, 0, 0, 0, 0, 0, 0, 0, 0],
[ 0, 0, 0, 0, 0, 0, 0, 0, 0, 0, 0, 0, 0, 0, 4, 0, 0, 0, 0, 0, 0, 0, 0, 0, 0],
[ 0, 0, 0, 0, 0, 0, 0, 0, 0, 0, 0, 0, 0, 0, 0, 0, 0, 0, 0, 0, 0, 0, 0, 0, 0],
[ 0, 0, 0, 0, 0, 0, 0, 0, 0, 0, 0, 0, 0, 0, 0, 0, 0, 0, 0, 0, 0, 0, 0, 0, 0],
[ 0, 0, 0, 0, 0, 0, 0, 0, 0, 0, 0, 0, 0, 0, 0, 0, 0, 0, 0, 0, 0, 0, 0, 0, 0],
[ 0, 0, 0, 0, 0, 0, 0, 0, 0, 0, 0, 0, 0, 0, 0, 0, 0, 0, 0, 0, 0, 0, 0, 0, 0],
[ 0, 0, 0, 0, 0, 0, 0, 0, 0, 0, 0, 0, 0, 0, 0, 0, 0, 0, 0, 0, 0, 0, 0, 0, 0],
[ 0, 0, 0, 0, 0, 0, 0, 0, 0, 0, 0, 0, 0, 0, 0, 0, 0, 0, 0, 0, 0, 0, 0, 0, 0],
[ 0, 0, 0, 0, 0, 0, 0, 0, 0, 0, 0, 0, 0, 0, 0, 0, 0, 0, 0, 0, 0, 0, 0, 0, 0],
[ 0, 0, 0, 0, 0, 0, 0, 0, 0, 0, 0, 0, 0, 0, 0, 0, 0, 0, 0, 0, 0, 0, 0, 0, 0],
[ 0, 0, 0, 0, 0, 0, 0, 0, 0, 0, 0, 0, 0, 0, 0, 0, 0, 0, 0, 0, 0, 0, 0, 0, 0],
[ 0, 0, 0, 0, 0, 0, 0, 0, 0, 0, 0, 0, 0, 0, 0, 0, 0, 0, 0, 0, 0, 0, 0, 0, 0],
[ 0, 0, 0, 0, 0, 0, 0, 0, 0, 0, 0, 0, 0, 0, 0, 0, 0, 0, 0, 0, 0, 0, 0, 0, 0],
[ 0, 0, 0, 0, 0, 0, 0, 0, 0, 0, 0, 0, 0,"home", 0, 0, 0, 0, 0, 0, 0, 0, 0, 0, 0],
[ 0, 4, 0, 0, 0, 0, 0, 0, 0, 0, 0, 0, 0, 0, 0, 0, 0, 0, 0, 0, 0, 0, 0, 0, 0],
[ 0, 0, 0, 0, 0, 0, 0, 0, 0, 0, 0, 0, 0, 0, 0, 0, 0, 0, 0, 0, 0, 0, 0, 0, 0]],

"units":[
["cheer",5,10],
["band",11,3],
["band",11,18],
["grease",18,18],
["cheer",17,7]],
"effects":[]

}


